12312312312312312312312312312312
21111111111111111111111111112111
31111111111111111111111111113111
12222222222222222222111111112111
22222222222222222222111111113111
31111111111111111111111111112111
11111111111111111111111111113111
21111111111111111111111111112111
31111111111111111111111111112111
11111111111111111111111111112111
21111111111111111111111111113111
31111111111111111111111111112111
11111111111111111111111111113111
21111111111111111111111111112111
31111111111111111111111111113111
11111111111111111111111111112111
21111111111111111111111111113111
31111111111111111111111111112111
11111111111111111111111111113111
21111111111111111111111111112111
31111111111111111111111111113111
44444444444444444444444444442444
21111111111111111111111111113111
31111111111111111111111111112111
11111111111111111111111111113111
21111111111111111111111111112111
31111111111111111111111111113111
11111111111111111111111111112111
21111111111111111111111111113111
31111111111111111111111111111111
11111111111111111111111111111111
21111111111111111111111111111111
11111111111111111111111111111111
11111111111111111111111111111111
11111111111111111111111111111111