12312312312312312312312312312312
21111111111111111111111111111111
31111111111111111111111111111111
12222222222222222222111111111111
22222222222222222222111111111111
31111111111111111111111111111111
11111111111111111111111111111111
21111111111111111111111111111111
31111111111111111111111111111111
11111111111111111111111111111111
21111111111111111111111111111111
31111111111111111111111111111111
11111111111111111111111111111111
21111111111111111111111111111111
31111111111111111111111111111111
11111111111111111111111111111111
21111111111111111111111111111111
31111111111111111111111111111111
11111111111111111111111111111111
21111111111111111111111111111111
31111111111111111111111111111111
44444444444444444444444444444444
21111111111111111111111111111111
31111111111111111111111111111111
11111111111111111111111111111111
21111111111111111111111111111111
31111111111111111111111111111111
11111111111111111111111111111111
21111111111111111111111111111111
31111111111111111111111111111111
11111111111111111111111111111111
21111111111111111111111111111111
11111111111111111111111111111111
11111111111111111111111111111111
11111111111111111111111111111111