33333333333333333333333333333333
31111113311122111122111122111113
31111113311122111122111122111113
31111113311122111122111122111113
31111113311122111122111122111113
31111113311122111122111122111113
31111113311122111122222222111113
31111113311122111122222222111113
31111111111111111111111122111113
31111111111111111111111122111113
31111111111111111111111122111113
31111111111111111111111122111113
31111113311122111111111122111113
31111113311122111111111122111113
31111113311122111111111122111113
31111113311122222222222222111113
31111113311122222222222222111113
31111113311122111111111122111113
31111113311122111111111122111113
31111113311122111111111122111113
31111111111111111111111122111113
31111111111111111111111122111113
31111111111111111111111122111113
31111111111111111111111122111113
31111113311122111122222222111113
31111113311122111122222222111113
31111113311122111122111122111113
31111113311122111122111122111113
31111113311122111122111122111113
31111113311122111122111122111113
31111113311122111122111122111113
33333333333333333333333333333333